#######
# o! # #
#@ @ #
#   @ #
# oo  #
#     #
#######