####
# o#
#  ###
# @  #
#!   #
#    #
######